original_file	None
graph_file	data/formatado/arxiv/exemplomenor_graph_1994_1999.txt
trainnig_graph_file	data/formatado/arxiv/exemplomenor/TrainingGraph.txt
test_graph_file	data/formatado/arxiv/exemplomenor/TestingGraph.txt
nodes_file	data/formatado/arxiv/exemplomenor/AllNodes.txt
nodes_notlinked_file	data/formatado/arxiv/exemplomenor/NodesNotLinked.csv
calculated_file	data/formatado/arxiv/exemplomenor/data.csv
maxmincalculated_file	data/formatado/arxiv/exemplomenor/MaxMinCalculated.txt
ordered_file	data/formatado/arxiv/exemplomenor/ordered.txt
analysed_file	data/formatado/arxiv/exemplomenor/analysed.txt
result_random_file	data/formatado/arxiv/exemplomenor/result.csv
t0	1994
t0_	1996
t1	1994
t1_	1999
decay	0.8
domain_decay	0.8
min_edges	1
scores	9:1,0;10:1,0
linear_combination	True
